NO textures/eagle.xpm
SO textures/eagle.xpm
EA textures/mossy.xpm
WE textures/mossy.xpm
F 0,0,0
C 30,0,0
1111111
100S001
1000001
1110111
1000001
1000001
1111111
