NO assets/ship.xpm
SO assets/ship.xpm
EA assets/ship.xpm
WE assets/ship.xpm
F 0,0,0
C 200,200,200
1111111111111111
1000000S00000001
1000000000000001
1000000000000001
1000000000000001
1000000000000001
1000000000000001
1000000000000001
1000000000000001
1000000000000001
1000000000000001
1000000000000001
1000000000000001
1000000000000001
1000000000000001
1111111111111111
