INTRO Sooner or later, you're going to realize
INTRO there's a difference between knowing the path
INTRO and walking the path

NO assets/wall_white.xpm
SO assets/wall_white.xpm
EA assets/wall_white.xpm
WE assets/wall_white.xpm

F 180,180,180
C 220,220,220

TXT assets/text.xpm
PLN 24,11.05,0.2 0,0.6 0.001,1 0

LVL lvl/level42.cub

1111111111111111111111111111111111111111111111111111111111111111
1111111111111111111111111111111111111111111111111111111111111111
1111111111111111111111111111111111111111111111111111111111111111
1111111111111111111111111111111111111111111111111111111111111111
1111111111111111111111111111111111111111111111111111111111111111
1111111111000000000000000000000000000000000000000000000P11111111
1111111111011110111111111111111111111111111111111111111111111111
1111111111011110111111111111111111111111111111111111111111111111
1111111111011110111111111111111111111111111111111111111111111111
1111111111011110111111111111111111111111111111111111111111111111
1100000000001110111111111111111111111111111111111111111111111111
1E00000000000000000000000000000000000000000000000000000000000001
1100000000001110111111111111111111111111111111111111111111111111
1111111111011110111111111111111111111111111111111111111111111111
1111111111011110111111111111111111111111111111111111111111111111
1111111111011110111111111111111111111111111111111111111111111111
1111111111011111111111111111111111111111111111111111111111111111
1111111111000000000000000000000000000000000000000000000011111111
1111111111111111111111111111111111111111111111111111111111111111
1111111111111111111111111111111111111111111111111111111111111111
1111111111111111111111111111111111111111111111111111111111111111
1111111111111111111111111111111111111111111111111111111111111111
1111111111111111111111111111111111111111111111111111111111111111
1111111111111111111111111111111111111111111111111111111111111111

