INTRO GAME FINISHED

NO assets/wall_white.xpm
SO assets/wall_white.xpm
EA assets/wall_white.xpm
WE assets/wall_white.xpm


F 0,0,0
C 200,200,200

111111111111111111111
1S0000000000000000001
100000000000000000001
100000000000000000001
100000000000000000001
100000000000000000001
10D000000000000000001
111111111111111111111
