INTRO 

NO assets/ship.xpm
SO assets/ship.xpm
EA assets/ship_trans.xpm
WE assets/ship_trans.xpm

F 0,0,0
C 200,200,200

LVL lvl/level3.cub

TXT assets/city.xpm
PLN 0,4.5,0 15,0 1,0.001 0
PLN 20.0,4.5,0 15,0 -1,0.001 0

1111111111111111111
1E01110000001100001
1001110000001100101
1001110011001100101
1000000011000000101
1R00000011000000101
1111111111111111101
1P0A000000000000R01
1111111111111111111
