NO assets/ship.xpm
SO assets/ship.xpm
EA assets/ship_trans.xpm
WE assets/ship_trans.xpm

F 0,0,0
C 200,200,200

111111111111111111111
1S1000000000000000001
101000000000000000001
1D101D100000000000001
1010D0D00000000000001
1D1D1D100000000000001
10D000000000000000001
111111111111111111111
